1 19 148 2939 3368 625 2842 2090 1712 3481 3030 2953 2823 3465 1608 1080 2864 2241 755 3042 2756 
1 10 148 1404 95 2899 3518 1462 1648 3524 581 2489 
1 18 148 3512 501 5181 1356 3114 3557 2999 2140 3580 2805 2706 1335 3622 3346 3634 113 2647 
1 3 141 3643 1391 
1 7 1391 194 1794 1104 1394 258 1936 
1 5 1936 2806 1846 1422 2805 
1 3 2805 1325 833 
1 2 833 3058 
1 4 3114 2791 3183 2797 
1 6 2946 3833 3841 3128 2796 3321 
1 9 2946 3285 3815 3310 3216 2671 2634 3802 2957 
1 8 3091 2709 3770 2809 2323 3797 2941 2957 
1 6 2178 3261 647 1642 3739 3091 
1 7 2178 2487 3674 3233 2265 2406 141 
1 9 2132 3738 3052 816 3734 1632 1336 3364 3091 
1 3 1060 3204 2101 
1 8 4114 1028 4146 394 4156 1352 4172 4177 
1 2 4136 2251 
1 11 2491 4958 2985 3294 4959 2763 2854 4134 4964 2918 1173 
1 6 4957 2839 2727 4056 4955 4954 
1 5 4091 4107 426 4135 4160 
1 9 102 1975 241 2072 972 2471 1667 2639 3632 
1 5 1868 1696 544 3632 141 
1 9 1868 2640 920 2825 2109 3624 3611 209 3603 
1 8 2178 3683 1636 2338 3694 2147 2799 2425 
1 8 972 3134 2071 3689 1507 3710 2879 816 
1 9 816 3748 3350 2128 447 2095 3823 2141 3846 
1 7 1657 3904 3899 478 219 3852 3846 
